
NO ./textures/wall_blue.xpm
SO ./textures/wall_teal.xpm
WE ./textures/wall_orange.xpm
EA ./textures/wall_green.xpm

F 152,  150,  150
C 194,223,250


11111111  1111111111111111111
11000000111111111111111111111
1011000001110000000000001
1001000000000000000000001
11111111101100000111000001111
1000000000100N000111011111111111
11101111111110000000000010001
11110111111111011101010010001
11000000110101011110000010001
  10000000000001  10000001001
 100000000000001  110100100011
11000001110101011111011110111
11110111 1110101 101111010001
1111111111111111 111111111111